00100000000010000000000001001000
00010000000000000000000000110111
00100001000010000000000001100101
00100000000010010000000000001000
00010001001000000000000000000011
00000001000010000100000000100000
00000001001010100100100000100010
00010000000000001111111111111100
00100001000010000000000001101100
00100000000010010000000000001000
00010001001000000000000000000011
00000001000010000100000000100000
00000001001010100100100000100010
00010000000000001111111111111100
00100001000010000000000001101100
10101100000010000000000000000000
00100000000010000000000001101111
00100000000010010000000000001000
00010001001000000000000000000011
00000001000010000100000000100000
00000001001010100100100000100010
00010000000000001111111111111100
00100001000010000000000000100000
00100000000010010000000000001000
00010001001000000000000000000011
00000001000010000100000000100000
00000001001010100100100000100010
00010000000000001111111111111100
00100001000010000000000001110111
00100000000010010000000000001000
00010001001000000000000000000011
00000001000010000100000000100000
00000001001010100100100000100010
00010000000000001111111111111100
00100001000010000000000001101111
10101100000010000000000000000100
00100000000010000000000001110010
00100000000010010000000000001000
00010001001000000000000000000011
00000001000010000100000000100000
00000001001010100100100000100010
00010000000000001111111111111100
00100001000010000000000001101100
00100000000010010000000000001000
00010001001000000000000000000011
00000001000010000100000000100000
00000001001010100100100000100010
00010000000000001111111111111100
00100001000010000000000001100100
00100000000010010000000000001000
00010001001000000000000000000011
00000001000010000100000000100000
00000001001010100100100000100010
00010000000000001111111111111100
00100001000010000000000000100001
10101100000010000000000000001000
00010000000000000000000000000110
00100000000010010000000000001000
00100000000010100000000000000001
00010001001000001111111111000110
00000001000010000100000000100000
00000001001010100100100000100010
00010000000000001111111111111100
00010000000000001111111111111111
